111111111111111
100000000010001
101111111010101
100010000010001
111010111010111
100010100010001
111010111110111
100010000010001
101111101111101
100000001000001
111011111110111
100000000000001
101111111111101
100000000000001
111111111111111
