111111111111111
100000000000001
101111111110101
101000000000101
101011111110101
101000000010001
111110111111111
100000100000001
101111101111101
101000000000101
101011111110101
100010000010001
111111111110111
100000000000001
111111111111111
