111111111111111
100000000000001
101111111111101
101000000000101
101011111110101
101010000010101
101011101010101
101000101010101
101110101011101
100010101000001
111010101011111
100010001000001
101111111111101
100000000000001
111111111111111
