111111111111111
100000000000001
101111111110101
100000000010001
111111101111111
100000100000001
101111101111101
100000000000001
101111111111101
101000000000101
101011111110101
100010000010001
111011111110111
100000000000001
111111111111111
