[
  "111111111111111\n100000000000001\n101111111111101\n101000000000101\n101011111110101\n101010000010101\n101011101010101\n101000101010101\n101110101011101\n100010101000001\n111010101011111\n100010001000001\n101111111111101\n100000000000001\n111111111111111",
  "111111111111111\n100000000000001\n101111111110101\n100000000010001\n111111101111111\n100000100000001\n101111101111101\n100000000000001\n101111111111101\n101000000000101\n101011111110101\n100010000010001\n111011111110111\n100000000000001\n111111111111111",
  "111111111111111\n100000000010001\n101111111010101\n100010000010001\n111010111010111\n100010100010001\n111010111110111\n100010000010001\n101111101111101\n100000001000001\n111011111110111\n100000000000001\n101111111111101\n100000000000001\n111111111111111",
  "111111111111111\n100000000000001\n101111111110101\n101000000000101\n101011111110101\n101000000010001\n111110111111111\n100000100000001\n101111101111101\n101000000000101\n101011111110101\n100010000010001\n111111111110111\n100000000000001\n111111111111111",
  "111111111111111\n100000000000001\n101111111111101\n101000000000101\n101011111110101\n101010000010101\n101011101010101\n100010101010001\n111110101011111\n100010101000001\n101010101011101\n100010001000001\n101111111111101\n100000000000001\n111111111111111"
]